 ################################### ###
#...................................#...#
#.#################.###.#.#########.#.#.#
#.#.......#.#.....#...#.#.#.......#...#X#
#.###.###.#.#.###.#####.###.#####.######
#.....#.#.#.#.#.......#...#.#...#.......#
 ######.#.#.#.#######.###.#.###.#######.#
#...#.......#.....#.....#.........#...#.#
#.###.###########.#####.#####.#####.#.#.#
#.#...#.........#.....#.....#.#.....#...#
#.#.###.#######.#####.#####.#.#.########
#...#...#...#...#.....#...#.#.#.#.#.....#
#.###.###.#.#.###.#######.#.###.#.#.#.##
#...#.#...#.......#.......#.#...#...#...#
 ##.#.#############.#######.#.#######.#.#
#.#.#.......#.....#.........#.......#.#.#
#.#.#######.#.###.#####.#### ####.#.###.#
#.#...#...#...#.#.....#.#...#...#.#...#.#
#.###.###.#####.#####.#.#.#.#.#.#####.#.#
#.#...#...#...#.....#.#...#...#.......#.#
#.#.###.#.#.#.#.###.#.#################.#
#...#...#.#.#...#...#@#.....#...#.......#
#.###.###.#.#####.#####.###.#.#.#.#####.#
#.....#.#.#.....#.........#...#.#.#...#.#
 ######.#.###########.#########.#.#.###.#
#.......#.....#.....#...#.....#...#.#...#
#.#####.#####.#.###.#####.###.###.#.#.##
#.#.#...#...#...#.#.#.....#.#...#...#...#
#.#.#.#####.#####.#.#.#####.###.#######.#
#.#.#.....#.......#.#.#.......#.........#
#.#.#####.#.#####.#.#.#.###############.#
#.#.........#...#.#.#.#...............#.#
#.#.#####.###.#.###.#.#.#########.#####.#
#.#.#...#.#...#...#...#.#.......#.....#.#
#.###.#.###.#####.#####.###.###.#####.#.#
#.#...#...#.....#.....#.....#...#...#...#
#.#.## ##.#####.#.#### ######.#####.####
#.#...#.#...#...#.....#.......#...#.....#
#.###.#.#.###.#######.#.#######.#.#####.#
#.......#...........#...........#.......#
 ####### ########### ########### #######
